..ARRGR..RRRR
RR.R.RRR.RR.R
Q.R.RR..RR.RR
.RRRRRR.VM.RR
RJ.RRWRRRIR.R
S..R.RRR...RR
.RH.RRR.L.RZ.
PRRT.RRR...R.
YR.RR..KXR.RR
.R.RRD.R.....
.CRR.RRERNR.R
.R.RRROURRFRB
