RWRRRNRLR.RRA
RR.RRICR.JXUR
RRR...R.SR.YR
R.R.R..M.RR..
R.R.RRV...RRR
RRRRR.R.RRR.R
RRR.RO.B...RR
.RRDRR.RRGR..
R.F.TRRRRR.R.
.R.HRR.R.RRR.
R.RQRRRRRR...
.RRRRER..RKRZ
PRRR.RR.RRRRR
