RRNRR.RR...RRRR
.RC.RRRSR.RRR.R
URRKRRRRRRR..AR
RRRBR..RRRRRRRR
P.R..QRRRRRRRRR
R..RR..R.RRR.RR
T.R.RRRR.JRL.R.
....RRRRR.RR.RR
ERR.RV.RXH.RI.R
R..M.RRRR.RRRR.
RRR.RR.G..R.RR.
R.R.RRRRRORRR.R
RRRR.RFRRYDRRRR
RRRRR.WRR.R..R.
R.ZR..RRRRRRRR.
