*.DT.#.L#...N
#*##KV*ELB.N.
*..UWY#W#SIN.
.#J.#NX.#*.#.
#K*LQTQ*...#.
.M#TAE.PV#..B
....Z#DV*#J*X
B..LXBQ..#OI.
#EQ..F*.#MF.C
.#LJ.#.KG.U..
...OVSB#WS.R*
*#.#.Q*E#..GH
