.....HB.#H..Q
F.#*K.TZ#.#.B
..#TWJD.##WZI
H..*..CE#.*..
EW.#*#...GJ.L
...NX..V.*LLG
*.#.D.N.SE*..
LD#*M##O#..#P
FA#L.#WU#...#
AOM#TFCCK#E**
O*##.V*OY.RU.
.C*#...RUM..#
.*EP#JS.DKGS#
