.D#.#F##KX.*##DH
N.HVW#*###.Q*V#.
U.WIV..ALDZ..#.S
X...#W##W.L.#S#*
AJWTYSY**#F*.*#N
.WF.###..S.##.E.
.OAD#U#S.###.Y*.
*.BQG*..L.P#*P*Q
.WF.X.I.X.Z.IW.I
.E##S.YRK#KBC#J#
ZT#..H.#U.#XDHC.
.HCRQ*K.OM*IX..Y
#..P**XT*Y.H..QS
#.#VBI*#T.ZZV.TG
#...CB*.##K.G*N*
X.VH...S#B.DJ.*.
