..R..RR..KRR.N.
R.RR.RRRRRR..RR
LRRR.W.Q..RRRR.
RRRRRRRRRRRRRR.
RRRR.RT.R....BR
RR.SRRRRRRO.R.R
C.RE...RRRR..RZ
MRYRRRRRR..RR.R
R.RRRR...RDRRRR
.RRRR..R.RR..RR
RRRU.RJRRIRRRR.
RR.RR.RRRRRRR..
R.RRRRRFR.R.R.R
RRR..PRHR.RARRR
.GRRRXRRRRVRR.R
