.R.R.ZNRR.R.R
R....R.R.RRRR
..RRRRR.JR.R.
RRR.RR.R..ODF
R.RRSR.R.R...
R.R.UR...RRL.
CRXM.RR.R.RRR
H.R.RR.R.R.RR
RR..RRR..P.R.
RRVRGRRR....R
TBR..RRRRR...
.RRIRRRRKEQAR
RRRWRY..RRRRR
