RR.R.R.RR.O..RTR.
RRR.R.IRRRRR.F..R
RRRRR.R..R..R..NR
RRRRRR..R....RR.R
BRRRQRRRRRRRRRRRL
RP..RERR.R.ZRRR.R
RRR.RVRRRR.RRRRRR
RRR..HR..RRRRRR.A
R.RR.RXRRRRR.D..R
R.RR.RRRRRRR.RRRR
.RRRRRGRRCRRRRRSR
RK.RRRRR....U.RR.
.R.RY.RRRRRRRRRRR
.MRRR.J.RRR..WRRR
RRR.RRRRR..RRRRRR
RR.R...RRR..RRR.R
