R.R..R.TN.RR.
R.URR.RRRRQ.W
RR..Y.L.RARRO
KRRGRRMRRRRRB
R.R.P.RRRR.RR
.R..RRRRRRR..
RRRRRRERRRJRR
RR.RRHR....RR
X.RRSRR.RRRR.
..R.R..Z.R..D
.RRRRRRRRR...
R.FIR.RRVRC..
