RRRR.RR.....RRRR
RRRRRR.RRR.RR.R.
RRR..RRRRRRR.R.R
..RRRRR..RRRNRR.
S.KRR.RRRRLR..RR
R.BR.RRR.ZRR.RRR
R.RRJR.ROR..RRRW
..YRRR.RCRR....R
RR.RRR.FRDRRRR.R
.RRR.RR.R.RRRRRR
.RQR...RRRR.RXRR
RRRRA.IRRR.MRRUR
.REGV...R.RRRR.R
RRRRRRRR..HP.RRR
.RRRR...R.RRRTRR
