*#..E#YU.H
...V.WRXL#
.O#.#O.ID.
*AQ..#.H.C
*#K....YVN
....#MZB.X
...CT..#.Y
#F..*J##..
EP.SR*#*#U
GD...#H.*X
