ZROB*JFC.DPY.I##
.*.LBWY..OA##.*V
.H##*LDM#J*..B#Y
EL#HM*YI##C*PLQ*
.#A#Q#SBGBWV#UB#
..ORGH#O*ZHUYMFZ
.D#....Q*OC#Z#HO
.GMK..RXU*..##.S
#M.U.#PM.#....R#
.*..LK##.VZ..T#Y
F.OP#*#BP.JY....
T.P*..##.XNO#D*W
O#*#*Y*.....##.J
..N#*FZ*Q.PO.N*.
V#O.IY..MZ##.#*Z
*GL.#TA.#.#D..#.
