*S*.M##ACAZ
#..U##.KY..
..BIRPL*.*.
.R#.#G#...*
#..WD.HAOJ#
.#C.XN.*#.T
Q....FE#W.F
.I.*VK....K
M#...O...Z.
.A.W#*E.#..
