RR.ORARR.RRRRR.
TRRI.RR.GRRRRLR
RSRRR..RRRRRRRR
R.DR.RRRRRRWRRR
R.RV..RF.RRR..R
C..RRX.RRR.RRRR
RRR.RR.RRRRR.R.
.RRE...R..Y.BR.
R...KJQR.RR.MRR
..Z.RR...RRR..R
R.RRR.H.RRU.R.R
RRRRR..RR...RR.
R.RRRR.RNRRRRR.
R.RPR.RRRRR.RRR
