.RLRRR.RRFR.M
CRR.RR.R.R.JR
PRRRRRDRRT.VR
R.R.RRRR..RR.
RRRR.RRR.RR.R
RR.RWRRR...R.
RRRXRRR.O.R..
.RRKRB.ER..RR
RR..RR...R.YN
.RRR.RR.RRRRZ
R.UAR.R.RR.HR
R.I..R.R.S.R.
RRQ..R.RR..GR
