IRRAER..R.RR
...RR.R...RR
RRR.RORRRR.V
RN.D.R....R.
RMRR.P..RRRR
R.R..RR....Z
WR.R..RU...R
RRRRRRR...RR
.RRRYRR.CRRR
.R.RLRK.RS.R
.GXF..RR.RRR
.RQT.H.RRJBR
