.H..R.YR..X
O.#*T...*#.
V.IXB.X##*#
FD#..*M.#.A
*RAO......#
TSGG..JN.##
.#.L..#CH.N
*Q..##.*E*K
.NZQP...#WL
.AU.#K.I...
