.RRRRR..ARPR.R.
.RRRRWRK.RRRRR.
.RL...R.RRRRRRR
......RRRRRENR.
RRR...RRRGTRRRR
RRRRRRR.R.R.R..
R..R.R.R.RRHRRR
RR.VRRRRRRBRR.R
RRRR.R...RRORR.
RR...RRR.RR.MRR
RD.RRRRRFR.R.XR
RRR.I.JRRRRRRRR
RRRURRRRRRRRR.R
YRR.RR.RRRRRQRZ
.RR.R.SR.RRC.R.
