RR..RRRRR.RRRR
.RRRRRWRRHR.RR
.R..R.RRR..DR.
R.QRR.Z.KRC.R.
VRRRBRRRRRRRRL
R.RRR.RRR.PRRR
R...RM.RR.RRRR
F.R.R..RURR..R
RISR.RN....JR.
R.R.R.RAR.R.RR
RE.RR....RRRR.
.RRRR.YRG.X.RR
.TORRR..R.RRRR
