.RRRRR.ZRRRR..RO
.RRRR.R.RRKR.RRR
.RR..RR..R.RRRRR
.RRRRRR.RRXMRRRR
R.RR..RRRRRRRRRR
N.R.RR.R.RR.R.RR
YRR.RRRRG.RRRR.R
.R.RURR..RR..PRF
RR..RRR..RWR.R..
..D.R.R.R.LRRR.R
RR.RR..R.RRRRIRR
RRR.RS.E.RR..RQR
RRRRHRRR.RR.VRR.
.R.R.RRRBRRRCRRR
....TRRAJRR.RRRR
