E#.G.ET#.P.K.U
..#I*V.##.#Y*#
DR..P*#O..*M.*
A.I.*#.BBJ.MMT
AT*R*N..#H.#**
.#S#EORR..#OT#
V#XZH.#..#..T.
.#YGO*H#.EZUZ.
#ELHQ.....*..L
M#..J..*I#Q.KL
Q#**J.PTF#F.##
N.Y#..Y..#U.BA
PH.##..BZW..CQ
