R.R..RRR.MR.RCRR
BRRR.RR.RRRR..RR
.NR...P.WZRRKR.R
RR.DRRR...ARRRR.
..R.R.RR.RR.R.RR
.JERRRRR.R..ROV.
RRRRRRR.RRX.RRRR
RR.RRRRR.RURIR.R
RRRRRR.Q.R.HRRRT
R.RRRRRRRRR..RSR
GR.R.RRRRRR.RRRR
RYRRRRRRRR.RR.RF
.R..RRRRRRRR.RRR
R.RR.RR.R.R.R.RR
RRRRRR.LRRR..RR.
