RM.RUR.RR.N
RSRI.R.RRBX
.R.K...RR..
PRL.YDRJR.R
E...VQCH.RR
RR.RWRRRRR.
OT.Z.RR.R.R
RRR.GRRR..R
RR.RAR.R..R
.R..R.F...R
