.*UV.F...#
L..H*..YS.
.P#GV#R#*N
.##.*..J..
D.*#WQ#C..
#.T*#L...Z
K.N..NOMEX
..#B...YA.
#R##..B..*
.#AM.FIM.Q
