RR.RRRRRRRR.RRRRR
.RRRR.RRR.RRRRQ.R
RRR..RR.R.RRR...R
R.RJRRRFRRRRRR.RL
RRRRR.RRRHRERRRRR
RYRRC.R.RRRRRRRR.
X.RRRRWRRRR.R.R.R
...RR...RR.R.R...
RDRUNRR.R.RR..RR.
RKR..RMR.R.R...R.
RR.RRRRRR.R...RO.
.RRSRR.RRRRR.RV..
A....RRR.RB.RZG.R
RRRRRRRRRRRIRRRRR
RRRRRTRRRRR.RRRR.
RR.RRRR.RRRRRPRRR
