.#.C*I.M.#X##B
*#.#R*ZKX#UBHJ
##*...H#...Y##
T.S.R..VWCM.#.
G*Z*#..Q..#M.F
..LNTWCM.DS.TJ
.....DK#R#QJP.
G#WY#C..D.II##
*S..UP##A...DT
***G*P.S**A.T#
##*B..##F.#..K
O#*..*..P#.MRF
.WSQGG....HGK.
.C#..LY#QZ..TE
