...R.R.RDN.
.R.OP.R.UR.
R..RRR..M.A
QR.....RRR.
..BRR.E.R.R
RRRXTFG..RR
R.VRS.RRRRR
RRW.RRRLK..
.R.R.JRRYZR
.RHRC.RRRRI
