R.RRR.RRR.R..R
.RK..R..RRR.RR
R.RRRAQIRCRRRR
.ORR.RRR.RRWRR
.RRR..RR.RRR.R
..RPXRYRR.M.RR
RNRRRR....RRRR
.FR...R.RR.RR.
.RR.R.RRR.G.S.
.RR.RRJRRVRD..
.RRRRRREZ.URRR
.LR.R.R.H.BRRR
RRR.R.RRRR.RRR
.RRRRRRT.RRRRR
