KRRRRRRRRRRRR.RR
RRRRIR.RRRR.FRRR
.RR.RRRRR....R.R
.RRR.VRRRRRR.RRJ
RRR.YR.RRRL....R
..RRRRR.RR.RRRR.
RR.RRRRRRURRR.R.
R.BRR.R.RR.RRRR.
.R.R.R.RR.RRRRRR
RRAR.R.RRRRR.GRR
RRRRRSR.RRRRZ.RR
R.R.O...RRRRDE.R
TRRCRP.RR.R..R.R
RR.RRRRMR.R.RR.R
RRHRR.Q.XNRR.R.W
