RRARRRRRIR.RRR
RRR...ZR...R.R
R..RRRRR.RM..R
R..RRRRR..RKRR
RRR..RJ.RRRRRR
PRRRRRRRRR.R..
RQ.CRR....RWRR
R.RR..RRRRURRR
..RRRRRROR.RR.
L..RR..RR.RRRR
R.R..R.DRR.XHR
R.FVTE.RYRRRRR
.R.SR.RR.R....
...BRR.N.R..RG
