I.ULER.RR..R
RR.RRRRRR.RR
T.R.GRRV..RR
.R..RCRW..RR
RNR.R...RRRR
RP..R.RRRR.R
SQRR.RRRRO.R
..R.RRJM..R.
...RHRR.RAR.
KBD..RRRRR..
FRRR.RX.ZRR.
...YRRRRR..R
