R.RSR.RRZRR
RRMRR...R..
RRR.RNRR.R.
RU..LERR.OR
.A.G.RRR...
R.RRRRCJP.R
.....Y.BR.X
.I..W.RR.R.
...RR.....R
.H.RR..FR.K
RRRTRVD.QRR
