*Q..DBRAI*J
...QT.M.##*
Q.A*C..*O.#
SR.VWW.#.C#
.....KCFSH.
.#.K##..PL.
...XS.W##V#
.#..#GUXE.F
#*#*...B.A#
*.HE.T*..#.
#.E..NY..Z.
