W.#..*RRKL*#W
#*GKYW#*##CSG
AZ.....*B.YS#
.A#.UU#U#*.#R
GGQE.Y*PX.*#.
..C###.IJ.*.#
*.SM.ZU#XCP..
..Q.DQ.F..S..
.SIE#C#.#OVTM
GH.FD.#*#G#.V
#..R*N.*.GQ#B
.W.H#*SBXI.NI
UK.#.##T..#*G
