.RRRRL.WRRRRRRR.
R.R...RRRRRARR.R
.RRRR..R..RRR..R
.T.RRR.R.RRX.RRR
RRRR.R.RR.RRR.R.
.RRRH..RR.RRNR.R
RCRRRRRR.RS.RR..
R.RRR.QRRR.RRRRR
..RRRRRDRRRV..RR
..RRR.RRFRRR.RRR
RRJYRR.R.PR.R.RR
.R.RRRR..RR...R.
.RRER.RRRRRRMZ.R
RR.RR..RRRRRRRRI
R.RRRRK..RR.R.RU
BORRRRRRRG.R.RRR
