*#EI#.K##LZR.
#F*#.CID.#T##
EO..SW.O....#
P...*.#D.B.QY
...H#.PP#N.SR
..S.JP...##*.
#C..DUH*GV.CM
.#VZN#M***QE.
#.*#W#E.R.#.*
.GZ.T#*RZMQAT
.MLE.A*.*XX..
YAK.##.K.W#..
