G.I.#.M..L*Z
..N...Z#.GJO
##.#AN..K.DD
N.K....Z#E#R
S.KJ.*CAG#U.
**.Z.#**U.*.
.BF.PO.#WVRM
..#K.#Z*RYA*
..M###Q.H#TI
#S###*Q.L..*
KB#XY.PR#.I.
*.Z#...WKDO#
