GGD#N#EX.HGC
.SQ#.I.*MR.#
#HZ#.U##K#.#
YTD*.#..**.#
YA..T*QUY..#
*#.K....*D..
..TLU*..OV.Y
WK##N.JM..U.
.#BFF.*LI..D
.PA#..K.O##.
W.J#O#.P#*W.
.KZ#U*XB..*.
