RR.RRRLRRRRRRRRR.
RR.RR.RRRR.RUW.R.
RRR.RR.R.RRRRR.R.
R.R..RR....R.R.RR
..QR..R.R.RRRRR.R
RRR..RRRRRR.RRR..
R.RR..R.RRRRRRRRR
R.RRR..RR..RRRR.R
RRT.RRR..ZRR.JOR.
..RRRR.RRRR.RRRRR
RRRRRRD.PNRRRRY.R
R.HARRR.RRMVR.RRR
.RBRR.R.RRRRRRRSF
.RRRGRR.R.RK.R.RR
RRXR.R.I.RRRRRRRR
RER....RCR.RRRR..
