.R.R.R.URRRMN
.RR.RRRRRR.RI
RRRRRR..RR.RR
.RBRR.RYRO.R.
.RRR..R...R.R
RRRRG.RFRVRRR
.RRRZRRR.RJ.D
RELRRR.RR.H.R
RR.R..RR.R..R
.RW.Q...R..R.
RCR.RST.RR.R.
AR.RPKX.R.R.R
