RRNRRRRRA.R.R.
RLRUPKRRR.RRRX
R..RRRRRRRRRRR
RRRRR.RRRRRR.R
RRRM....R..RRV
WR.OR.RQRRRR.R
RRR.RR.RR.RRBR
R.R.R...R..IR.
GRRR..RRRR..RR
.R.RRZC.RJ.R..
R.TR.R.RRR.R.R
RRRDRR.R.R.RR.
RS..RYHRRR.RFR
RRRRRR..ERR.R.
