.VXR.L..RZR
RRR.JY.ORRN
RRC...RR.MR
.R..FDI..T.
.RRR......E
PRRRK.R...R
RR..R..RR.R
RURRR..RRR.
..SBARRG.Q.
RWR.H....RR
