R..UR...R..
RRR.RR.RMA.
R..RT.CDRR.
RRR.R..R.QR
ERRRRHRR.RR
...NR..RJ..
.RRSR.R.RYV
RX.R.RR.R.R
RRR......BO
LR.ZR..F.R.
W.RRPKGI.R.
