.#*.UZ.*.
#O.#.#.Q.
I.N#..#P.
M.WU*.#L.
.XIG.K..*
BEZY#.#.#
R*.V.*FL#
S..J.CDAI
.#.T...H.
