R..RRRR..R.RRT.R
.RQRRRR.R..RRR.R
RRRRWR.RRRRI.R.R
RRR.RRRR.RRR.RRR
RRRR..RR.RR.LRRR
RRRRGRRSRR.RR..R
R.RRRRRRCRRR..RR
.RR.JRRRR.RR.RRR
RR.RR..R.RRRRR..
ARFR.R.RRRR.RBRR
.RRRUXRR.RRRR.RR
RRRR.OR.RRRRRR.R
.R..E..V..RRRRRY
.RRRRR.RRRR.RRRR
KR.RNRZRRR.RRDRR
R.RH.RRRRRRRMR.P
