RCARRR..RR.R.RRR
RRR.RRSRL.RRRRRR
RRR.RTR.R.R.RRRR
RRRR.RRRRORRRPRR
R.RRRR.RR.RRRJRR
RRRR.RRRR.RVYWRR
RRRR.RRR....RR.R
NRRRRRR..R.RRRR.
R.RRRR..RRR.RR.H
R..RRR...GZRR...
..R...RRRKRRRRRB
R.MRRRRR.FRRRRRR
.RRRRQ..RRRRRR.R
RRXRRR.R.R.R.EI.
RDRRR.R.RRUR.RRR
