*U#.TFA#F.S...D
.#XK*..Y.VLV.#.
J...#ZYJE.O#I.G
##.TQSFH#U.P*LP
#X.*BPZ...T..E.
#UAAE.P.B.#T#QN
CCF#.#.O*M*FX.*
QH.Q.Y#.QC#.Y..
..*#O#**..##Q#.
###O#.GER#.#AG#
LNH.O.#N.*.#V.X
VWR#RV.*.IL.I#*
*.....RF.#PBIR*
.*B..H*##W#.QH*
