....RXNARRR
FRRRRRR..RR
..RR..K.RL.
RRRR.Z.R.RR
R.M.RR.YTR.
WI.RRRR....
...SRBPE.RR
.RRJ.ORRRR.
R..RR.....H
RRV.QRDR.GR
RRURR....C.
