.*...MV.O.
X..#*..KAP
FIU.ED.TU.
*.C#....U.
.*A.#..RHZ
#.H.T.N..B
L...#G....
Y.W.S#.*##
#.J.#E#Q#*
