XRRRRT.RR.RRRR..R
RRRHRR.R.R..RRRRR
.RRRRR.R...R..RIR
URRRD.RR.RMRR..RR
RFRRP.R..R.RR.RRR
.RRRRR.R.RRRR.RRR
.Y.R..RRRRR.RRRRR
RRRBRRRRRR.RRR.RR
RR.RR..RR.RRRRRR.
G.RRRRRRRSRRRR.RZ
..R..R....RL.RRRA
.WRKRRRRR.R.RCQRR
..RR.RN..RRRVERRO
R.RRRJ.RRR.RR..RR
RRRR..R..R..RRRRR
RRR.RRRRRR.RRRRR.
