RRR.RPR.RR.RRR
RRDSR.R..R.ZR.
..RB..RR..FKR.
ERR.URRHR.RR.R
RR.RRRWR.R.RRR
.RRMRNRR..R.RL
..RAGR.R.RCRR.
QRR.RR..IRRR.R
RR.YR.R..RJX..
V.RO...RR..R.R
RR.RR.RRTR..RR
R.R.RRRRRR.RRR
RRRRR..RRRRR..
