#R..R#PF..M.X
F.#.GTL.A.BVA
JD.XEZT**...Z
B..B#*#E.PGO#
RZ..#SS.FP.T#
.**J*V*X#D#.*
B#..##Y.XRSQ.
..YMG.#J#N.O*
EAJ.MK#.#O#O#
Q#.W*#.EPCH*N
UGI*..#T#....
#.G.#.*I#.##.
..Q..#T.HU.*.
