#P#.#..##MR.H
...LS.GNJ*PY.
LB.GJG..IFQ.*
#C#U.R#.J..D#
ULX.PC.A..PO.
.*M*#X..##**.
J#.Q*S*O.KU*#
.S..HX.A.EL.M
#*#.E..#N.K*#
#.HDJ.#T*.#S.
*##..#.VGA.Z.
.#.TF#ZYTW...
