#.S#...*#
..O.*R.V.
K#I...NM.
.F#..DJ.#
.T#.#.UW.
..NBHCV.*
X.X.**P##
Q....S..G
Y.E#...AL
