OCR.VTX..R.G
RRRRSRRLRZRR
R.RRRR..R..F
.RRRR.RRR.R.
KRRRRR...R.R
RRRR.R...R.R
.RR.W.RU..R.
R.IRBRRRRP.J
R.R.RM.RRN..
R.RRDH.RR..R
RRRE..RRY.RR
.QARRRRR.RR.
