RRR.R.....RRRR
R.R.NXRRRR..RR
WC..RRR.RRRRRR
RRRRRRRRRRRR.R
.RM..RR..R....
RRRRRKRRER.R.T
RRRRR.RRRRRRRR
RRD........R..
.R.RRRZRVRYR..
.RRRRRSR.RR.R.
.RRRRRRR..RRL.
.I.RRARBRRQRRR
.RR.RHRPG.JRRR
FRR.RRR.OU.RRR
