RGRCRRR.I..RTRR
RR.R..RM...RRRR
.RE....RPRRR..R
RRRRRRJ..L.RRWR
.RRRRR.R.R.RR..
R.RRRRR.XR.RRR.
.RRRR.URQZRRR.R
RAR.RR..R.R.R..
V.RRD.ORRRH.RRR
RR.RRR.RR..RRRR
RRNRRR....RRR.R
RRRR..RKR..F.RY
R..RR.R.RRRR..R
R.S.RR.RRRRRRRB
