B#O*##.I.UO.X.YG
BYB.F##.B##C*#GK
K.SRNP#L*U#YU.#R
ND.#.Q#..BXL.##I
O#.CDF*D.OLY...#
.E*..A...M#XRU#.
..D..#.##U.*#ROZ
#...#..ZR.YL.*..
#RAE*I.B.W.M**J.
#TOQV.R.***VS.*.
I.Q#*#TLG##G##B*
....*G*#L*.XRVT#
GL*GAISFY.IX.#PJ
.#MQ#VD.SQC.#.*.
#...HEF.#.AW*SV*
GK##YV..VD.#K##.
