TD.R....CR
J..R.G.FA.
S.RR...RRR
..RRURWK.R
.RBVYLX..R
.R..RIE.RN
R..R.MRRQ.
R..RR.RRRZ
...RR..RHR
.O.R.R.R.P
