RRR.RR...RMTRRRR
RWR.RRRZRRR.RR.R
RR.R..RRRER.RRRR
....R..RRRRRRRRR
RRRR.RRR.R.IRRR.
RRR.RRRFRRRQR.RR
RG.RRRRRR.RRRRRX
RDRR.RUV.P.RRR.R
RRR.R.RRRRRR....
R.LRRRRRA.CRRS.R
RRR..K.RRRYRBRR.
RRN..RJRRR..RR..
RRR.RRR.RRR.RRRR
RRRRRR.RRHR.RRRR
.RRRRR.RRRRRRRRR
..RRR...RRO.RR.R
