.YM..UWR.RRIRR
RRRRRR.RRREPRR
..RR.R.RRLNRRR
R..R.RRRR..RRR
.RFRRRRZRRRRR.
RR.RRRR.RRR..R
.RRC..RRRR..T.
.DRRV.GRBRKR.R
.HR.RRRS.R..RR
.RRRRR.RR.RR.R
.ARRQ.RRRXR.R.
RORJRR.RR...R.
.R.RRR.RR.RRRR
