RR.R.RR.RRRRRZ
R..RRRP.R.RI..
.R..RRRRL.NM..
RARRRRRR.RRR.R
RRRR.J.R.FRRRR
RR...RRR.R.R..
RRRVR.RR.R.RHR
.RR.R.R..DR.UR
YR.RR.G.RRRR..
RR.R.RTX.RRR.R
RRR..RRREKQRR.
.WRR.R.RR.RRRR
ORRRR.RRRSRR.R
RRRRR..R.RC.RB
