RRQRRR..RFR.
.RR..RRRRRRH
RRR.R.TRRR..
...RRPIRR..R
ZRRO..VR.RR.
RR.R.JRGRRRR
RLRS.RD...XW
.B.RR.RR.RU.
..RRRRRRKRYR
R...E..R.R.M
.R.R.NA.RCR.
