RRRR.RRRWJR.LRRR
RPR.R.RRRRURRRRR
.RRRR.FD.R.R.RI.
RRRRR.RRRR...RRR
..RA.R.RRRRRRZRR
R.RR..RRGRRRR.RR
RR.RRRR.R.RRRRRN
RR..O..RRRRRRRQY
..RRRRR.RRR..RRR
RRRR.R.R..RCR.RM
RSHR.R.R.RRRR.R.
..RRR.VRRRRR.KRR
R.R..RRR..RRRBRR
..RRR..R.X.RRRRR
RRRR..RRE.RR.R..
R..RRR.RRTRRRRRR
