N.##B*.DR.#W
..*.#YX.S*.#
I.Q.#BH.F#.#
KQNV....U.KE
N###.S.O#.B.
.*..JODSX.SM
E.D.UW..#.*U
Q*GG.EBLVT#.
#.*I#.#OUG#Z
U*#PXC#..HA.
*..*#..#.*Y.
