.RMR..RRRR.RU
..AY.RRFR..RR
VRE.R...RR.RP
R.RR.RRRBRR.H
RRR.Q.R.R...C
RRDRR.RR.R.XR
.RR.RR..R...R
R..R.RRR.R.T.
RRRRJRRRGR...
RN.....R...RL
R.RR.RSRRRORR
RKR.RZWRRIRR.
