R..RRRC..RRRRRRR
RWRRR.GR.R.RRRR.
RRR.R.R..RRRRNRR
DRERRTRR.RR.RBRR
RR.JRM.R..RRRR.R
RR.RR....RRRRR.R
PRRRRRRR.RRR.RR.
...KRXRRRROR.HR.
RRR...R.RR.V.R..
RRRRRSR..RRRZ.QR
RRR.URRRRA.RRI..
.RRRRR..RRR..RRR
R.LRR.RRRRRR.R.R
R.RR..RR.RRRR.RR
RYRRR.RRR.F..R.R
