R.HRR.RRR.RRRY.R
RRRRR.R.RR.RRR.R
RR.RRRR.R.RR.RRR
RRRRR.R.RSRRR.RR
R....RRR.KRRRRRT
RRRRA...RRR.RRRI
..RRRR.RRRR.Z.RR
RRCR..RRR.RRRR..
RNRRRR...R.R.B.R
R.RRRRD.RRRR.RR.
.RRRR...RRRR.R.V
.QRRRR.RJRRRRRR.
.RRXU.RR.RRRRFMR
RR.RRRRRR.R.RER.
RRRR.RROR.R..RPR
.RRRR..RWRG.R.RL
