R..J.S.I.
AB#....O*
*H#DV...F
..#*.##I.
#.EMF#G.#
PN.L..TN.
...FXWQ*.
C..#..*K.
...#.#..U
