RR.R..RRRRNRBRO
.RRRRQRRRRRR.A.
R...RR.RR.RR.R.
RVR.RRRRDRR.RRR
.RRRRRR...RRRRR
RRR.RL..RRY.R.R
RRRGRRRRR...C.R
R.R.RRRRRR.TW.R
RHR.R.RRRRRRRRP
RR..RR.RRRRR..R
R.RRRRRR.URRIR.
.MRRKRRR.R..RRF
RR.RRRRERRR.RR.
RRJ.R.RR..RRRZ.
RXRRR.RRRRRS..R
