VRJR...RRRY.R
RRERRRR.RRRRR
ZRD.U....RRRR
.RHRRRR..R..R
R.R.RRR.RR.R.
.RR.ROR.A..RI
R...RRRB...F.
RRRRRK.XRLRR.
RRRRMRR..RRR.
.RRN..P..RRRR
.WRRRRRR...RR
CRS..R.R.RRRR
RQRTRRGRRR.R.
