..RRR...HRR.
NRR.ZR...ERR
.MRRR.R.R.RD
KX.RFR..QR.A
RR..R.S.....
R.RLRB.CR.RR
RR.R.ORW.RRR
YPRRRR.RRRVT
.RR.R.RR.RRR
.....R.R.R.R
IJ...R.RRGU.
