Q.I.#..#.#
*#.A#..R.#
W.....D.EI
TY.*..#QJ.
UV*NR#.G..
.XPHO.C.ZL
#.RK#.SO#J
*..#L**F..
W.B.....M#
