R..BRR..F.
RRDYXRETR.
.....N.C.P
Q.RI.RKR.V
URJ.RR.R..
G..HW.ZRLR
.R...R..AR
RO.....RR.
..SRMRRR..
