RRRRRRRRRRR.RR
R.RRRRW..RRRRC
...RRRRRR.RM.R
R..R.H.R....RR
RRR.BJ..R.RRXR
RRR.SRR...V.PR
.RRRR.RR.NRR.R
RF.R.RRLRR.RRR
DRRQRR..UR.R.R
RRRR.R..RRRR.T
.R..GR..R.R.RR
RRIR.RRKR.RR.R
R...R..R.ZR.RR
RARE.RORYRRRR.
