RR.RRRRRR.DRR.RR
R..RR...RV...RRR
RRR..RRRRR..RR.R
RRRRRR..RR.R.RRR
RGRKREJYRRRRX.RR
RRRHRRRR.RO.RR.R
R.RRRRRR.RRRNRR.
.RRRRRRRRRRRZRRR
RRRRRR.RSRRRRR..
LRRR.RRRRRR..RP.
RRR.RRRARRRRRRRR
MR..RRR....RRRRR
RR..FRRRRIR....R
RRU.R..RRRR.R.W.
RRR.R..RBCRRRRRR
QRT..RRR.R..RRR.
