RRRR.F.RRR.TU
RR.R.XRB..ZR.
RRRRRRW.RR..R
..RRQRRL.RR.R
.RRA.YRRRRR.R
R.RVRR.RRNR.R
RRR..R.R.R.C.
RERHR.RR.ROR.
RRRRRRR.RGR.R
R.RJRRRD..R..
RRRRIRKRR.RPR
RRR.....RRRRR
R.RSR.M.R.R..
