HR.R.RRRRRSR.RRR
RC.RR.RRRRRXBR..
RRRRR.RRR..RRRRR
RORRRR.R...R....
R.RLRRRGRR..RRRR
QRRR.R.RRRRR.RRD
.R..RR.R.RMRRRRR
RRRRR.RRRRRVRRRR
RRRRRRR..R...RRR
RRRRRRRRRRZRRRRR
..FRRRRR.RY.RR..
RR.RRIRR.RRPRARR
.RREKRRR.R..NR..
RR.R.RRTRR.JRRRR
RR.R..RRRRR.RR..
RRUW.R.RR..RR..R
