SR.B..R..RRRR.OR
RRR.RRRR..RRRRRR
RR..RR..R.R.XRRR
.RRRRRRVRRRR..R.
RRRRRGRRRR.RZARR
RRRRRRRH.RR.R.RE
RRR.RR.RRRRRRRRR
.RRR.RRP.R..RRRR
RR..RRRR....CTRR
RIRRDRR..R.RR...
..FRYRRRRR.RRRRR
...RRRRRRRR.JRRL
RRR.M.RRR.NR.URR
KRR.W.QRRR.RRRRR
RRRRRR...RRRRR.R
