WM.A.W##.#.
.D#O###..*N
TQ.W.K*H..#
*L#.S.*.#.G
...*B.PZRV.
E#JXR.F.E*#
JX...#OCC.F
CZ#Z.Y..YU*
OA*N#U*..##
U.Z...I.#..
