Q..R.RRR.R.IRRRR
R.R..R..RRRHUAX.
RSRR...R.RR..RR.
RRRRRRRRR.RRR..T
R.RRRRR.RY..RRRR
.RRR.RRRR.ZRL.RV
RRRRR..RK.RRRRRR
RR.RERR.JRRRRR..
WRRR..RR....RRR.
.PRRRRRRRRRRR.R.
RRR.R..RR.R..R.R
.DRR.RRRR.RR.R.R
RRRRR.RRR.RRFR.R
ORRRR.RRRR.RGRR.
BRRNRRRM.R..RCR.
.RR.RR.RRR.RRRR.
