FRD.RRR.RR.
RR.MTR...R.
.C..R.RR.Y.
...R.RH....
RQR..RU.ERX
R.R..RNGRZR
RRJRR...IRR
LVA.R.R.R.R
.RRRPKRR...
B..WR.R.SRO
