RR..R.VR...
.RRR..RRR..
R.WRDRRS..I
R.R.R.J.RRT
..XRRRBRRAU
RRR.MYR.R..
R.R.R...HR.
O.Q.R.RRRR.
RZRPRCFERG.
.R.LRN.R..K
