RRR.R.XP..RO
R.RYRRWRR..R
.R.IR.R.J.AK
RG..RRR...RR
R.R.RL.R.RR.
RR..DRF.RSR.
RT.RR.BUVRRR
RRRR.HRR.RE.
R.RRRRRZRR..
RRR.RRR.MR.R
R.R...RRCRQ.
.RNRRR.R.R.R
