..##RD.*Y..
.#F.*#OW.KS
#EPSB#...AT
.SA*I..XH.Q
#MG.WAW#X#U
.U.KZLNQ...
.*#.P##*..A
E#D#SCJ..#.
Y.#..#.JN**
*#.Z..X#.S.
V...A.*#Y*N
