R..RR...W..
R.RGAR.RKRR
R.ZTURRRRRR
.....RRYL..
..RSRR...RR
.DRRR....N.
R.RPX...RQR
CBRORR.R.R.
RRR..RFR..V
R..RRR.RJ.R
ERI.RRHM..R
