ORRCRNT.RRRE
.R....R..SRR
DYBR.F.RRRR.
RRRV..U.MR.J
...PRRRZR.RR
R.RRRR.RRXR.
GRR..R.RAR.R
RRRR...RRRRR
H..RRRRI...R
..R.WRR.RRQR
.RRR.LR..RK.
