N.FR.R..A.
RRRTG.RU..
MYWO..RRR.
ZD..X.RCR.
.R.R..VPRR
RRRRER.RRR
..R.RL..R.
RRRH...RK.
RRRS.RQRI.
RR.BRJ...R
