.RR.R.RWOR.RR
J.LRR.RRRRH..
RI..R.BRRRRR.
FTRGR.RR.....
R.R.RRR.S....
RR.RR.RAKCR..
..Q.E...R.RRU
RRR.RR..RRXRR
.RRY..RR.RRRR
.RRDRRRRRR.R.
...RRRRRVRPMZ
...RRR.RN..RR
