.#.LU#WQQ*#
.Z#R*AL..#.
.#*.*#..#..
.Z#JS..#A..
*O.##.T.#.*
.H.P#L..F.I
.YEN.X#P..*
F*.#DKIG..*
.MG..RDR..F
..#B#AS#E.D
..X.YCDU.RV
