R.RR.RERRR..R.
R.R..RBRRRRR..
.R.RR.RRR.R.RR
..RCR.R.ORR...
GRZXRRRRSR.RRR
..RDR.RVRRR.RR
RRR...RRYRQM.K
LRRRRRWFRRRR.R
RR.RRRRRRRRR..
..RR..H..RNRR.
T.RR.ARRRRRRRR
R..RR.RRRRRRIR
RU..RRRJRRR.PR
