RRR.RJRRRRRRRRR.
RPKRRRRRRLDR.TRB
R.R..RR.RRR.ARRR
.R.RRRRR.R..RRRR
MURR.VRRR.YR.RRR
R.RRW..RRRXE.RRR
R.RRRRR.SRRR..RR
RR...RC.RN.RRRRR
.....R.R..R..RRR
..RRRHRRR..RZRRR
ORRRRRF..RI.RRRR
R..RRRRR.RRRRQRR
RR...RRRRRRRRR.R
.RR.RRRRRRRRRRRR
RR.G..RR..R..R..
