RRR.RRFP.RRRRRD
IR.RJR.RRR.RRR.
HRRR.R.R..RRRR.
RR.RRR.RRR.R.RR
.RR..RRR.NRR.X.
.C.RRR.RRR.R.RR
RRRRRRER.RRRRRR
R.R.RK...RV.RGR
...R.RRRRRRR...
RR.RRRR..RRR..R
.RR...RRYRRRRRR
WU..R.RRRR.RR.R
MORZR.QRRRRRRRR
RT.BR.RR.RRRR..
ARRRRL..RSR.RRR
