R.R.HZRR.RRAR.R
R.R.RRR..RRSR..
RRRR.RRRRJRRRRR
R..RR.RRRR.KRYR
.RR.PR...RRIR.R
R....RRR.RRRR.R
..RRRRRRR..RR.R
.RRRR..ROR.RRRR
R.RF...R.RR.RD.
R.RGRT.RRR.R.RR
RR.RR.XERQRRRR.
.RRRR.UR.R.RMLR
.R.R.R..R.RRR..
RRRRRR.RRRRRR.V
R.RNRRRCWBR.R.R
