.DR.RRRRR.RRR
.RR.RRRRR.RC.
G.RRRE.R.R...
R.ZRRR..RJ.R.
SF..RR.RR.AB.
.RRR.R..RRYRI
.....WRRRRRNR
RM.RR.RPKRRRR
RRURR.RRRRVR.
R.RRRR.R.RRHR
.TRRRR.RO.R.Q
.RRRRX..RRRL.
