W..S..PKRRR.
RIR.R....R.R
R.E.R.RR.R.R
RRRRV....RXR
RTRR.R...RRR
R..CYRRRRHDR
R.JRRRRR..R.
..R....R..R.
RUZQR..MGR.B
LRRR..RRR..R
RRRRF.RRNORA
