V.M*..##..M.*
.....#.DNT*Q.
C..AC..#.#..K
L*W.**W.####.
#.ZPM#U*...#H
F##.O.GZAH#.X
##J##.F.TDYHJ
.V*A.PI.T.K..
HAB##.##*#K..
.X.P.B.I*.YSE
.U.KWN*NUQJT*
G#P.P..U.E.*.
OR.O##QZE..*#
