BRR.RRIRR.RRRR
R...RRRRRX.RRR
.RRRRLRR.WRRR.
R.RR.U.R...NQR
R.R..RRR..R.R.
T.RRR.RRRR.AR.
.RR..RRE.R.ZR.
.P...R.RKR.RR.
RRRRGRRV.R.RRR
...MCRRR.O.R..
RRRR.R.FRR.RJ.
.RR.RRRD.R.YRR
RH..RRRRR.RS.R
