R..KRR..RR.RRRR
..RBRC.RRRR.RRR
R..RH.I..R.RRRR
.R....RXRU.RRRR
...RRRRRRRRADR.
RRPRRRQR..RTFNR
RRL.RR..RRRWRR.
.RR.RRRR...JRR.
RRR.RRR..RRRRRS
.RR.RRRV....RR.
R.RRRRRERRR.R.R
RR.RRRM.RRZ.RRO
RRR.RRR..R.RRRR
..R..RYRRGRR...
