IRRQ..SRR..RRRR
..RRURRRJRRRRRY
R.RRR.R.RC..RRR
ORRR...R.RMR..R
KRRLRRX..RRWR.R
RRRRR..RRRRRRAR
RRR.RRRRZGR...R
RVHRR.RR.RB....
.RRRRRR.RRRRRRR
.R.RRRR.RRRRR.E
RRRRRR.RRRRF.RR
RRRRR.RRR..R.RN
..R.RTR..RRR.RR
R..R..RR.RDRR.P
