R.B.RR..RR.R
..F..WQ.R..E
R.RRR.R..RGR
R.RRZRR.R..R
.R.RRR.JRLRR
RR..RISRRRC.
.URRMRKY.TXR
.RORRHAR.R.R
...RR...R.RR
..RV..RDR.R.
.RRNR.P.R.R.
