CRRRRRARRR..RG.R
K.R.RYR...RRRRRR
.RRR.R.R.RRRRRR.
ORR.RRRRNURRZRRR
BRRRRR.RR..RRRRX
.RE.RRR.R..RRRRR
.R...WR..RR.R.RR
RRR.RRRLRR.RRRI.
.RRR.R.R.RRR..RR
RRR..RRRR.RRRRR.
R.S.Q.RRR.RFRR.R
J.RRRR.PV.RRRRR.
RRDR.R.RRR.RR.RR
RR.RR.R..R.RH.RM
R.RRRRRRRRRTRR..
