RRRRRR.RRRRR.RR.
.ARRRRR.RRJIRRX.
..RRRRRRRKRR.R.R
RR.RR..RRRRZRR.R
R.R..R..R.RR...R
RRRRRR.RRRRRRR.Q
RTRR.RRGRRRRRRR.
RRRRRR.RR.R..R.R
RRRRRRRR...RR..R
RS.RRRR...RRRRR.
R.RRNR.RWU..PER.
RRR..RRRR.R.RR.R
RRR.RRR..RRY.RRR
.R.RRRRRR.RCRRRF
LRRRMRRR.R.RRRBD
.HR..O.R.RR.RVRR
