RR.RRIR..RRRRR.
.RRRR.G.RRRRVRR
..R.R.R.RX..LRR
..R.RR.R..R.RER
RRORRRR.RR.JRRR
RR.RRR..RR.RRRT
RMR..KRFR..R...
RR.ZRDRRRRRRHRR
.RRRRRRRBR.RR.R
N..RRRRRRR.AR.R
RRRRRRRRRRYRRRR
RRRQSR.R..RR..R
RR..RPRRRRRR..R
..RRURRRWRRRRC.
