A.B..G.HXZL
A.##*#*V.WT
I.#*.*....*
*YFP#*.M.ZD
M..B#..#.F#
..EK#.O#...
.S.RU#NUKC#
..JX..N#Y.P
...Q###..OT
S...*.N#.KQ
