...#.#Y.XB*.O.B
*J.L###D.*T....
E#A.#RH*Z#.U*ZD
*.J.#KP.XM*.U.S
SP#L.#O*#.YJ*.#
WQO#GC.W.N#I.A.
#*F....*V#OUD.P
I#LQ##.#.XW#*..
#*M....JV#.O.GK
FE.*C*...WRD.D#
*#J..M#I#..#.G.
T#.#PKI.*.F#CK#
B*WH.V.GB.N#.NO
N.I.#.#HB.A.VPD
