.W.RT.R...
BV..RRRRRY
H..N...RRR
IR.JRER.SR
P.RO.R.R.G
RFMR.L..RR
R..RRRRRDK
..RAR.RU.R
.R.RR.ZCR.
....R.X.QR
