RR..RRUG..R.
RRR.........
RRR.RAWFRRR.
.RRR.RRRRV.H
RRRNRR.R.P.R
RRRRRR...R.R
I.RRBRRY.RDR
.RZ.RRR.R..K
R.RRORLXRRRR
.R.R..CR.R..
RRRTRRQ.RRR.
R.ESJRMR..R.
