..RRRRRRDRRRR
RRR.R..RR..R.
RBR.R.RIRM.R.
RRRRRXRQ..Z.R
.O....RRTRRRR
R.RURRHR..JN.
...KRRRR.RPRG
RR.RRR.RRR.RR
RV.RR.RRRA.RR
.RRRR...YRLRR
.R.RR.RRR.R.E
RR..FR.SRRR..
..RRCR.RRWR..
