RRR.RJ.R.RRR.R
RR.RR..R.ERR.N
RRRRR.R.RRRRDR
.RRR..FRRRR.RR
ROR...RR..R.RQ
..BR..R..RZRRR
R.RR.RRRR.RRLG
RR.IRRS.RARR.R
PR.RRR....RVRR
RRRRRRRRHRRWR.
RR...R.RRR...R
X....RR...RRT.
C..YRRRR.RRRRR
RRM.RR.RRURKRR
