.RU.RQC..RXR
..R..W.RRR.T
FRR....R.R.D
RRR..R.J..VR
R.RR.RZ.R..R
RARR..LR..RR
R.PRIRRR.RRB
RRRRRRR...R.
H..R.RREG.NR
RSO.RRRRRRKR
YRRRRRR..M..
