#.P.X#.KBQ
*...#.N...
..#..VS...
FY.....O#.
.B*W*H.MG.
*#*X..*DAU
LF.#I....#
BEJ##.Z#*E
.##..O.X#C
.FG..RNT.E
