C#..BWMSNU..X
*..G.*CDZ#N..
#E.K.RS.N.F#.
..Q#G.FR#X.VK
*O.#.#VY.M.S*
#NEU.#TFTG#.Q
..#*P*V.##T#G
W.WFA.Q#U*Q.M
MW#.##.##*I..
.#L...AME#.H.
YJBC#X.#...#C
.*..T*..#*B.#
A*V..A*..Z.*F
