ON*D#NNZDC#
...BG..#HA.
...#OP.....
.TQ.*#A#U..
.I..G#J.*..
..X.E#D#DHY
.*.OR#Q*K..
S#..*.#.#R.
KNM*.*#W#VT
..IY*.L..F.
F.XL..##S#.
