R..RR..TR.S
K.RRRR.GRF.
RYR.I...ROR
RLUR.RRR..R
XR.NJRRRVWR
..R..RRR.RR
DRRRR.R...R
.RQRRCR..RZ
.RP.RRB.R..
.RM.R.R..RR
RRA.E....RH
