R..RR.RRRRRR.RAR
RRRR...RR.R.RR..
RRFR.RR..RRRRR..
R.RRWRR.RREZ.RRR
RRTRR....RR...RR
.RGRNRRRSRLR.PRR
RR.RRRRRR.RBX.RR
.R.R.MRR.R....RR
.RURRR...RRR.RRR
R.RJRR.R..RRRRRR
.RRR.RRRRR.RR..R
RRR.HRRVRRRRRRRR
RIKR..RR..RRRR.R
.RORRRD.R.....R.
RCRRRRRY.RRR.RQ.
