.*YSF.#ID#
...S#..#O.
..J#ELBU#.
XW..A...C*
K.M#....*.
#TQV.GGK.*
RB#...#NH.
V....#*.Z.
KP..R*.##.
