BU.#.Q.*.L*
A.E#WOEDH..
.R..#QYNK#.
..T.H*#...F
G*X.#..L...
...##TS*Z#T
*#I*I.#.#F.
B#CPG...D.V
.*K.#O..JGK
#.S..M.EF##
