RRW..RR..RE..
RRMR.FR..R.R.
.RCR.RRQR.RRR
RX.RRR.ORRRUR
...T.RJR.RRR.
RRRSR.R.A.RR.
RRRRY.R.RGZRR
.RHRRRRRRR..R
RDRRB.R.R.R.R
R..RRR.RLRKR.
R.P.R.RNR...R
R.RR.RRRR.IVR
