.RRR.RR...R
WR...RRRV.I
.ZR.RR.RR..
RT.R.U.RKR.
.RRRRRR..X.
..RR.ERR.R.
RR.N.MG.RRR
....P.SRQR.
R..RRC..HDJ
AR.LRRRORRR
RRRB.Y..RFR
