CL*WF*PW#.AFB..
PY.#N*#W..HVXO.
.Q#.#*#*Y.OXSN.
I..#ZTCG###KQ.#
T#*#VC.JVAUJR#.
E.J.X.S.F..B#*M
B*.X*O*##.PGIQJ
A#U..*.Z*NDHC..
.R*.#J.W#B.*YD.
A*###U#*VH.F#YE
W#Q#..O...##I##
W.*..###OPC#P#K
G...LE...HS..#.
..Q.X#ZW..*.L*O
