#M.H..SU#D
....#TPH#.
.Q#.#H..#R
VW.G#ZK.*.
B#B*..NOK*
#QF...L.N.
CUR#X#*..*
MI..#.C.A#
R*..Y.#.XZ
E**.#J.O..
