R.RR...RR.R.KR
..RRRRR.R.RRSR
R..RR.RR..RR.R
.RRRRMR.RR.RRR
RRRR.RVRRRRR.R
RRRRRRRRN...BR
.RRRR.RRZARIOR
R.RRRR..RRYRRR
R...PRRRC.RR..
.R..R.R.RRE.RR
.RRRW...RR..RR
RH.RRR.TG..RRR
JRRRUR....D.RR
RRR...R.QFRX.L
