RR....TRRFE
ZI.R.RRBRMQ
PCJ.R..R...
R....RROR..
.R.RR....WH
..RVRD..S.U
RRR.RRRRRRR
..RR.RRR.RR
LRR.K.RXA.R
R.G.Y.R..RN
