R..R..RRR.R.HRR
.RRRRRRFR.RRRRM
..SRRRRR.RRR.IR
R.RYU.DB.R.RRR.
.RRRRL..R.RRR..
.RRE.RRRQ.R.RRR
RR.RRR.RRRRRR.R
RRRRRRZRR.GROR.
.RR.R.RR.RRRRRN
.R...K...RRRJRR
.RRRRRRRT.VRRRR
RR..RRRR..RR.W.
R.R.RARRRRCRR.R
.RRRRXRRR.RPRRR
.RRRRR.R..RRR..
