RRP..RR.RRRR.NR.R
RRR..R.RBR.RXDRRR
RR.R...EROR.R..RR
R..R.RVRRRRRRR.R.
R.RRR.RRR.RRS....
.R.R.RRR.R.R.R..R
RRRRR.R.RRRR...RR
MRR.RRRRR.RRRRRRR
RR.RRRR.YR.GQ..RR
RR..RRRR.R..RR.R.
K.RRR..RRR.RRZTRR
RR.R.RRR.IRRR..RR
RRRRRR.RRRRRC.FHR
RRRRR.RRRRR.ARRRR
RRRRRRRR..LRURRRR
RRRWRRJRRR...RR.R
