*.#AY#RX#H.P#PHB#RA#
***E.SI#C.Y....#X#A*
##*GU##.B.RS*.ZXQO*.
.FS#F.R.B.**V.#.WILT
J#LAL..##I.L*UYDQJW#
..#W#.*.RS#A#GM*B..G
#.KJP.##P*#SAABAKOZ#
.*#.C.R.DY#U#AK#R#*#
O##**#...S*##.I#I*PJ
MIJWAW#.AP#.AC*.M#SJ
YV.**A#.ER..QV.*R.Z#
*#V*#USIBRS##.H.SX.O
RQ*J*.#A#Q.##A.Q#DR#
##O#GNN...H#YX....YN
KBP#..J##.*VS...C.J*
B#Y*B*ZU#.WHTIT#VBDO
#ZN.#.XNOPAFU**ZZ.JT
#L.HC#.*QV.IRE#...#X
MGM*#...*FN.P##Y.Q..
