V..FR..URR.R
..RR.R.R..RK
B.R.R...R...
.WRRXRRAR.R.
RONI.RRYRR.R
RR.R.RDRL..R
R..MRCRRRRRR
Z.R.RRP.RQ.R
.RE.RR.RRRRR
.....RRR.R.R
..RRRRJ..R.R
.TRR..SRGRRH
