RDXRSR...RRRR.R
RRRG...RR.RR.E.
ZR.O.RR.RRRR.RR
RRRR.RR.RRRRRR.
R...R.R..RR.VRR
RRR.RRRR..RRTRR
RRRIRRRRRUW...R
RRRR.QN....R.RR
.RRR.R.RRRR..RR
.AJRRRR.FRRRP.R
..R.RR.RRR.R.RR
CRRRRRR...RR...
RRRR.BR.RR.RYRL
KMRRR.R..RRRH.R
