R.RA.R.RRRRBRR
RR..X.RR.RRRR.
...RRHRR.O.RRZ
..RQR.R.RERYRR
RRR.RRR.RR.RLR
RRRR.R.RR.JRRC
.R.RRR.RR.R..R
W.RRRR.TRD.RRR
NRRF..R.RRRRR.
RR.K.VRR.RRRRR
RRISR.R.RMRRRU
R.RRRRRRGRRR.P
.R.R.RRR.R.RR.
R.R.R.RRRRRRRR
