RRRRRR.RR.J.R.
MRR.RRRRRR..R.
ARRRRRR.ZRR..R
.RRRRRRRR..RR.
....R.RRHGWR..
RRPR.RXRRCRRR.
.RSR.URRR.IRR.
OREF..RR..RR.R
QR.R..RR.R.RRR
RRRBNR..RR.D.R
RRRVRRTRRLRR..
RRR.RRRRR..YRR
RRRRRR...RKR..
