#DI.OK.X...V
FZSURU...K.*
F##..#XG.K.M
.SLB##...RZ#
#..HW#.*##Q*
QCS.#SOT#*P#
S.*.**N#.AQD
X*....YG*..E
..#.F..D*#.P
A.G#.A.#..VN
MV#....J#.P.
