RR.RRXRRRRRRRN
.R.RI.RR.RR.R.
WL.RRRRR..R.R.
RRRR..KRRRRR.R
R.....RSQR.RER
.RRRR..Y.R.J.R
RRRRR.RR...RFR
RRRZRR.RR.PR..
R.RRDRARRRRRRR
.RRR.RRCO.RRR.
.VRRRHRRRRRRRR
.RMRRRRRR..RR.
RR..R.BRRRRRRR
RRUR.RR.G...TR
