.RRRMR.R.IRRRR
CRDRRR..RR.R.R
RRRRRR.K.RRRRR
RBROHRRR.RRRRR
.R.R.ZRNF.RR.R
..R.RQ..RRR..R
RRR..R.LYRR.RR
RRRR.R..RR.R.R
.WRRR..SR.RURJ
ARRRRRR..E..R.
.RGRTRR.R.RRRR
RR..RRR..RRR..
XR.R.RRVRPR..R
