G#.L..I.
..##..*.
.HB.*...
K.#GA*..
..C.M#F.
.#D..F.J
N..O.E..
