.#.T.M#HX.CV
.L.ZS##.#T*.
...D#N#.J*..
K#X.#NL..M.E
....V.OR.PZY
*X..#R..C.*.
*..##..JTS#.
JFYB.#G..I.I
.W.X.HQ##..C
HAR.OJ#Z.P#*
F##PN*#**.GI
.D#**.#.U.C.
