RR.QRRR.U.RRRRC
R..RR...RKRRRRR
E...RR.R.RRRR..
RD.RRRRRS.RR.RR
RR.RR..TR.RR.RR
R.BR.RRNR.R..RR
..R.RRRR.PYR.RR
.Z.RRR.R..A.R.R
.RRGRRHRR.RRRRR
RRR..RR..RRRRRR
MRRRRRRRLFRRRR.
RR.RI.RJ.RR.RW.
RRVRR.RRR.RRRRR
RRR..RR.ORRRX.R
