R..RRRMRRZQ.R
.RRRRR.RRRRKW
..R..RRRRRRR.
...RJR.....U.
.RRTRRRIRPRH.
RAR.RRRB.RRRE
.DR.N.RR.RLR.
..C.RR..XR...
RRRRRRROR..RR
..R.RRR.Y.R.R
RRGR.R.V.RRRR
FRR.RRRRRS.RR
