.RRROSRRRRWRR..
RRRBRYRRRRMRRGD
CRR..R...RR..R.
.RR.RRRRRRQR.R.
RRRT.RRR..R.PRR
NRRRAZRRRRFRRRR
KRR.R..RRR..RLR
R..R...R...R..R
RRR.RR.RR..R.RR
R.R.R.RRRR..RRR
VHX.RRR.R.RR.RR
RRRRRER.RR.RRRR
.RRRJRRR.R.RIRR
R..UR..RR.RR.RR
