..RRR.CRDR..R.
R...RRRRRRRMR.
URJRRRRRRR.RR.
RR..RRRR.R.SAR
.RQR..RRRRRRRR
RRR.RRRRRRHEOR
..RRR.RR.RR..R
...T.RR.RRRRY.
.RRRR.RRR.RRL.
...KVR..W...FR
RI.RBRRGRRZ...
.NRR...RX.R.R.
RRRRR.R.R.RRP.
