YQ.T*##.P#*VI
VYRJJY#**GH.V
....X.##JP*N#
.O.*K..#**B#*
.#...DT#FJ.#V
F...#*#W.V#B.
WO.Q.#.FZZQ.A
U##DV#R..CG.U
H.Z*S...#.##.
..NI##EV#IM#S
R#J.....KH#.P
*..#.C.YG.DC.
..GLQQ.JP*.O*
