RRRRR.RRRR.RRMG
N.RRR.RRJRPRRRR
XR..R.RR.RR.RR.
RR.RRHRIR..RRRR
REU.RRRRRRRRRRR
..RRRRRRRRRRA..
RD.RR.ORRRRRRR.
RR.......KRR.R.
RRRR.RRVR..R.RZ
RRR.L.R.RQR....
SCR.R...R.R.RR.
..R.RRRRRR.RF.R
RRBR.R.R.R.RRWR
.RR.RR.RRRRRYTR
