RR.RR..R.RR..
..RR..R..RRRR
.RRRR.R.DK.F.
.RRR..R.R.NRR
RLJ.RR.RRR.RR
.RHRR..R.....
RBRRR.RR..RRR
RZRO..RR.WR.R
RRPRRR..Q.A.G
RTRR.M.RR...R
R..VRRSRRRRRR
RUXRRRE.RRRRI
RRRRY.R.R.RC.
