#K*..P..T
F..#.#.O*
.XC#U###.
.#.T*.AHM
V.R...P.E
G....LWNW
.#*...D#.
.S#B.GQ.#
I*..D*Y.J
