*.#.#MJIC.
.#.WG.....
D*.UQ*V#..
..D..L..A.
.#HV#EN..X
#RK#O*#S*T
*E.Q..F.*B
H##Q...WP.
K.Z..DY###
