RRZ.RRR.RRRRRRNR
RRGXS.R.RRHPRRE.
RR.RR.RMRR.RRRRR
RRRRRRI.RRRR..RR
RRRRRRRQRRRRRRFR
RR....RR..RRR.RU
R.RL.R.RR.RRR.RR
R.R.R.RJ.RR.R.RR
RRR.RDRRR.RRRRRR
R.RRRR.RBR..RRRR
RRRR.R.RARRRRRRR
.RR.R....R.RO.R.
RRRRR.RR.R.RRYRT
RRRRRRR.R.RR..RR
C..R.RKR.RR..WRR
RV.RR.R...RR..RR
