.R.RRR..R..ER
.GPRYR.RRH...
.RW.T...RRZRR
RR..RR..RR.R.
RRRRRR..RRL.F
RRR.RCI..RQRR
RRURR.R...R.B
R..KR.RXORRR.
R.RRRRRR..VD.
RR.RRR.RMR.RR
JR....RR.RRA.
.NRRRRRRR.RR.
RRR...RS.RRRR
