RRROR.R.RR..R
RR.RR..RRRRR.
RRRMRRRRRRVRW
.IRRRRR.HRRR.
R.RRR.RRQ...R
..NRU.RERC.RB
.R.....RRRRRR
RR.FRRRPRL..R
RRA..S.RR.RR.
TRR.R..RRR.R.
..RRY.RRR.KJR
X.RRRRRR..RGR
RRR.R.Z..R.DR
