WRRRR.RRA...
RR.R.RN..RR.
CRF.RRLRRORR
RRRZRR.R.RR.
...RR.R..R.M
RR.RRRTK.Y.R
.R.SR.R.R...
PRRRRU.RRJR.
RRX.RRRRB...
RRRRDRRRRRH.
I.RR....VRGE
.RR..RQ..R..
