..#..#*..*.Z.JQ
N#..**G.Q..E..V
.L#W.U.Q*.N#M..
I.QS..AZ....R.W
*V*OVPXE#.M#.HF
*.##.#H.NQ..EV*
#L###.F#*NR.XF.
.#HP#Y.J#NLY...
SO#.DAD.#BF##C.
ND..*L#DY*.K..I
*.A#B#.Z.G.*#..
.#T.VN##G*UGYHN
#I*.*J#KB##CX#E
AGV.MZA#.HGP.#*
