.ORRRRRGRRERR.
R.RNIRK.R.RRRH
RRRRRRRRRRR.R.
RXR.RRR.UR..RR
RRRR..RR..R..R
FR.RRRRRMZARRR
RRB.RR.R.RR..Y
RTQSRWR.R..R.R
.R.RRR.R.RRR.L
.RR.RRR..RR..R
D.R...RR.RR.RR
RR....RR.RJ.VR
.R.R.PRR.RRC.R
