RR.F.RRRR.Y.
RR.BRRRRE..R
RRRZR.RDJ.RR
..R...L...RM
R...R.R....R
AR.RR..RRORR
..RR.RURR.R.
RIRGKRRRC.R.
.XWPRRR.RRRN
RRRRRRR.....
..R.R.RVR.R.
RQR.RTR.RRSH
