.W.F#D..*..#
.J.*WCH*.P#Z
*ZT.UL.*Y.#.
XNGP#W.#...*
.QLWX##R#.SF
L*D.*.RSW.TU
#J#.#R.G..FE
..A...#M##GI
C...#B.YV#*.
#K.I#..O.V..
*.L.M.#...H#
