RR....RR..R.R..R
RRRRRRRRRREDRRRR
RSRRRBRRR.RRRRRR
RRRRR.CRFR.RRRRR
RRRRRR..R.RRYRZR
RRR...R.RRR..L.R
.R.R.RRWRRRVRRRR
RR....R.R.RRRRRG
.RRJRRR....R...R
R.RRRR..RRR.RRRP
RRXRRRRRMRRO.RRR
T.RRRRQR.RRR.RRI
RR.R..RR.R.R.R..
.RRR..RRRK.RA.RR
R..R.NRRR.RRRRRR
R.RRRRRRRURRRRHR
