I*K...EE...#
AG#U.M.U.#.#
.#U.#....*.*
JO.*CCF.#H##
*#DDF...P..Z
.EF.N..#.X#.
*YC.I.QB#.#.
R**VG#RP.U#Y
K.W.E.AG*..O
S##J#.VC.#T#
#*LMDUIX..*N
