RR.R.PR.ZYRRR.RR
.RRR.RT.RR.RRRRR
..RRR.RRR.RRRRJR
RRRRRRMR..S.R.RR
.R..LRRR....CR.R
RRRRRWRRRR.R..RR
.R.O..RRRKRRRRRR
RRBRD.....Q.RRV.
R.FRR..RRRRR.RRR
..RRRRR..RRRR..R
.IRRR.RRR.RRU.RR
RRAR...RERRRRRRX
..R.RRR.RRRR.RRR
RR.RRRRRNR.RR.HR
R.RG.R.RRR.RR.R.
