Q.JW.UPB.H..M
F..#.AZBVE#*.
NNQ#.###OA.*T
#YF#M*SG*.E#.
#X...F#*##J.*
.V..#BWTK.#GF
.*.X#L.#.....
Y.#*..K.LD##.
.COY*..##WMGT
G.*SPQ.#.P#JJ
QJ#NK.ZY..#PC
I..*E#*#*.C.P
.VR*L*##OA.WJ
