RR.R.ZRRTRRRR.R.
RRRRRRRRR..RFRRR
ORRRRR.RM.RR....
R.R.RRR..RR.R..R
R.RRRRR.RRRR.RN.
.GR..RR.R.R.RRRR
VRRR.R..R.RRR..R
R.R.RQRRWR.RRLRR
RXRR.RRRRR....RR
.KRCR.RIURR.RRRR
RRRR.RRRRRRRP..D
HRRRRR.RBR..RR..
.SR.RR.RJRRRRRY.
ERRARRRRR.RR.RR.
RRR.RRRRRRRRR.RR
