R..RRRK..RR.
RR.R....RRRR
RRRR.RR..R..
RRRR.WRRRR.X
RRRR.SRU....
JR..RRRG.R.R
RRR.F.....RR
RRRRM..T.RR.
NI.ECRRVRRB.
RZ..D.RY.LRA
Q.RHRR.R.P..
.RRR.R....OR
