RCO.RRYR.RRRRRTRR
RRN.R.RRRR.R..RR.
R..RRXR..RRRRWSRK
RRJRRRRRR.RRR.RRR
RR..RRR.R.RRHRRRR
RRRRRRRRRG.R..RR.
.RRRRR.R.RRR.RRRZ
.RP..RRRRRR.RRRI.
.R..RRL.R..VRRAR.
..RRQ.RR.RRRR.RRR
RR.RR..RRRRRR.R.R
R.RRR.R.RR.R.R.RR
URRR.RRRRMRRR...R
..RR.RRRRRR.RRR.R
R.RRRR.R..FRRRRBR
.R.RRR.RR.DRRRRER
