RR.RRRRDR.RRRRRR
BRHR.RR..R.RRCRR
RR.RRR.RAR..RRRR
R.RRKJRR.RR.RRRE
RR.R.RRR..P..RRR
...RRRRRRRRRU.RR
R.RRR..RR.R..R.R
R.R.RRRRRRRXYRTR
RRR..RRR.RL.R...
R..R.R.NR.RR.R..
R....RRR.R.R.R.S
RRR..RR..R..RRR.
RR.RRZRRR.RQGR.I
RRRRRR.R.RRRRRRO
R.RRRRRRRMRRR..V
RRR.RR.RFRRRRRWR
