RRRTR.R.RRR.R.R
R.R.RPRE.RRRRL.
RRDR...RR..RRR.
RRRRRH.R.RRR.RR
R.RRRRRRRR.RRRA
.RRRRRK.RRR.RR.
RWR.RR.RB...I.M
RRR....R..RR.RR
RCZXRRRRRRRRR..
.RRR.RRR.RRJ..R
RRY.RRRRRR.R.RR
.OR...RR.RRR.RR
RR.RRR..GRRRR.R
QR.RRRR.R..VRR.
RR..FRR.NUR.RSR
