RRHRRRRRRR.R.RR.R
R.R.R..R.RRRRRR.R
RRR.R..RRRRRRRR.R
RRRRRRRRVRRIR.RNR
RRJ.RRCRRRRRRR.RR
RRRP.RRRRRRRR.R..
R..Q.RR..RRRRRRR.
RRRRRR.RRRRRD.RE.
RRR.RRRR.RR.RRRR.
RR..RRO.R.RRT.RGR
RRRRRR..KZ.RRR.W.
RRRRURRRR.R..RR.R
RR..R.RRRRR.RRRRR
.AFLYR..RS.RR.RR.
R.R..RR..R...RRMR
.R.R.RRRRRR.XR.RB
