.#......
..##BE..
..CGFD0.
..#JAFN.
..0GK#I.
.#.HO...
...0ML..
