..RRRRRRRRRR.R.
R..RRRR.R.R.RR.
RRRRRRRRRRZRYRR
KR.F.RRRRRRRRRA
RHR.E.RRR.RR..R
..Q.RR.RRRR.RRR
RRRR.R..RRRR.R.
RRRR.R.R.BRRO..
RRMRUJRRRRR.RX.
.RR.R.R.RLRRRRS
.RR.R...RRRRRRR
C.RRWRR.RRRRRVI
.RRG.P.NR.RR.RR
T...R..D.RRRRR.
