*#.....TUQ#**.SV
XV.Z..#DP***E.#.
##*Y###H#F#.J*.A
.#IZZ.*#*.#.OT.P
F..#D..L*..R#.IR
#Q....PGJ.B#TNGW
###D.OBNH*.TO*.N
K#.DMQ*S.*DT.PM.
.G#R#TU.E*.JKBL#
C.S.A##..*#A.VJN
T.YX*#JT#.S..W#.
#KE.O*..R.X..F#*
#.F.YF..#*H..MTT
T.C#.QB#GLVYUOY#
.###V.H.T.MK#.B.
