RRR.R.RRRRR.R
RRU.RLR.GR...
MRRRRRRRRR..I
.JR.RR.D.RRRR
KRR.PB..RQ.AR
RROR.RRRRR..R
.R.SRR..VR.ZR
W..RTRR..RR..
..FRR.RRRRX..
NR..H.R.R.R.R
R.RRR.RR..RYE
.RR..CR..R.RR
