..RR.YG.RRJ.R
RR.RR.RR.RR.R
.CRRR.R..RRR.
RRRNRR.RR.RRB
RR..IR.RSRE.Q
T..RURP.R.DRR
...RR...RVRR.
RLRRF.RZ..RRR
RR.R..R..RRR.
RRRRR.R..R.RR
R..RRR.RXRRR.
OR...KRR.RRRR
HRW.R.R.RAMRR
