AP#S..J#A*..
M#TCEYF*.BN.
#L....F.#.HH
#.#...M.#F..
.P...#IGW#UF
.*##..R#.T#X
*SOT#MV*VX.*
..LK.##*TF.D
#.G.HBC.#..D
.NZD..J.#...
..*.**...LVQ
