RR.R.BX.K..RRV
RR.AFRR..R.YRR
RRRRRRORRR..RR
.RRRRR..RJRRH.
RR.RRRMRRRR..R
RRRR..RRRRRRR.
R.RR......RR..
RR.RR.I.RRR.RW
.R.RQR...RU.RR
R.RG..RRRT.R.R
R.RLRRR.R.RRRR
RRRNZ.C.RR.RER
RRRRR..RDRRRRR
RRRRRPR.RSRR.R
