RRRYRRRR.S..RR
RRRRR..R...RRR
RRRRR.GQ..WZ..
.RRRRR.NDRRCRR
.RRR.IRRR.J.RR
RR.RRRR.RE.R..
.R.LBRRKVR.R..
RR.R.ORRR.T.R.
RRR.RRRR..H..R
..RR.R.FRR..RA
RRRRRRRR.UR.RM
R.R.RR..RRRRR.
.R..RR..PXRRRR
