#S...L..TNSE
*X.I.*M.A*G*
..ID.*.C.PRY
T*.OR.D..DB.
##.UUHJI.*.*
#.F##..D##*O
JVO#####P##.
.CAKV#ZF.Y.#
.HU.##..#.LR
I.V#Y#..T.WX
*#UN.#*.QA.X
.S.*.#MFM.HF
