#E#K.*S#.DDSM
CWYX..#B.JL##
U#...L..PQX#.
.#.JB#.J..QNC
**..L..W*PZ#G
#B.##XY**#RTW
#...A*.#.DQP*
A#..#.WU*EN..
...#.M*.#WB*Y
F.S#SN.E.Z.*W
LE...IGVZOGL#
*#.GX..D#H##.
