RRI.R.RRRRR
.R.JRR.UM..
R..VE..N.R.
RRZ..K.XSR.
RRRLRORRF..
RRQYR..R.RR
WRBR.D.R.RR
CRRR.R.G...
.RR..R.THR.
PRA.R..R...
