RR.R.IRRRRRRR
.RR.DRY.R..RV
R.MRR.R.R.RFR
R.C...RRRRRRW
RRRRPQURRR..N
R..RRRRR.RR.A
.TRJR..RR.R.R
RRB..G...RRRZ
.XRRRRRLRRR..
..RRRR.R..SR.
K.RR...RRO.R.
.....RERRR.RH
