RE...RR....
Z.RBRD.R.R.
.W.RR.H.R.R
RRRFN...RRA
R..RRVYRRRR
RR...R.....
Q.MR.RRPI.R
..R..RTUR..
RRR..GLK.JR
..RS.CXRRO.
