.L*.*SZ.*#.D.
#D*K.###*..R.
H.#*....#*..A
LPPNY....##XD
.L..#..A#IAVH
...#..Q.#P..T
.FY#B.#YDC#M#
E*ZH.#RTX.G.K
##DO.XGTV..K*
..A.U.Q*YQ*.#
*N...#..GU#DJ
U.R#CWS.W..#O
