RR.RRR.RRRR.R.R.
RRR.RFR..RRRR.RR
RRR.DRRIRR..RRRR
RR..GRRR..RRTRRR
.R.RMRRR.ARR.RRR
RRXR.RR.R.RRRR.R
R.RRRRRRRRRRRRRW
RRBRR.RRURRRRRRR
RN.Z.P.R.R.RRR.R
RCRRR.RRRKR.RR.R
RRRVRRRR...OR..R
.R.R..RRRRHYR.RR
.L.R..RRQERRRRR.
.RRR..RRRRRRS.RR
R.JRR.RRRRR.RR..
