CRRP.R.RR..H.RR
.RRRRRRMRR.RRRR
R.RR.RRRR.RRYR.
RR.RRRRRRRRRR.U
.RRR....RR.R.RR
R..RR.T..VR..RR
R.ERRRARRRRRRRQ
R.R.RGRRRRRR.R.
.RRR.RRR.R...RR
R..R.RR.RRR...J
.R.RSRRRR....RR
WRRR..RRF.RRRR.
RRXR.R..RRRBR.R
.KRRZ.DRLRR..IR
RRR.N..ROR..RRR
