RRC.RR.R.VR.
R.ZR..RKYRRW
.RRR...NFJ.R
.RXRRRR..R.R
H..RR..R.ERB
.RRMQR.R.DT.
PRR.....RSR.
....RIRRUAR.
R..RRRRRRRRR
RROR.R.RL.RR
.RR.RR..RGR.
