.RRK.RRR..RRHR
F.R..RJ.RRRRL.
ZRRRR...RRRRRR
.RRRR.....RRMR
RN..RBRRRO...R
RRRR.R.R.P..RR
RRR.RG.RER.RRI
RR...R.WRARRCR
RTR.R...Q.SRRR
RURD..RR...R..
RRRRRRRRRR..RX
.RRRR.RRRRRRRR
.RRRV.YRRRRRR.
