.RRIRRRRR..R.RVR
RRORER..RRRRR.RR
.RTR.RRRWRRR.R..
M..P.R.R.RRRRRF.
RX..RR..RRCRRRRK
RR.RRRRRR.R.RN..
UR.RRR.R..RRBR.R
RRR..RRR.RR.RRRR
.RRR.RRR.RRRR...
RR.RRR.DRQG.RR..
.RRR.RR.RRRR.RRR
R.RRRRR...RYR.RR
RRRR...R.RRRSZ.R
RRJ...RRRRHRRLRR
RRRRRR.RRRRRR...
RRRRRR.ARRR.RRR.
