P.#.S.R#KX
V....J.N#.
FKI..*.L..
F*#.#H..*.
*.U.#AT#R.
BW.*E.#QU.
.P...H.OXT
..#VMC.D#.
..Y.Z*#...
.#BG..*.##
