URRRC.RRRYR
B.E..TRXR.L
.PNAR.RR.RR
.RRRR..R.RM
RKS.R.RD..R
RJRR.RR...R
RR.WRR.VRR.
F...RR....R
RZRR.RR.GRR
.QR...R.ORR
.R...I.HRRR
