...RRRR.RRRR.R.
R.RRR.G.RR.RR.R
QR..RRRRRR.RLRR
RR..R.J.RORRRRR
RRRRRRRRRB.R.R.
RS...R.RR.RRR.W
RTRRRRRR.RRURRR
RMRPR.R.NR.RRRR
.RRVIRRRYR.R.R.
R.RRRFR..RRR..R
RERR.R.RRRRR.R.
.RX.RR..DRRRRR.
.HRRC..RRRRARRR
R...Z....KR...R
