.R..RRRRRJRRC
.EHRRO..RR..V
RU.RRRRRRRTRR
RRRRRRRW..RRR
R.P..RRRXI.DR
RNRRR.R.RRRQ.
R.RR.RRRR..MZ
RRRR..R.RRRRR
RRR.Y.RGRRRRR
.RRARSRRR..R.
B...R.RL.RRK.
.R..RR.R.R.RR
RRFRR.R.R..R.
