RRIVRRRRGRR.H..
RR.RRRS.QXRRYRR
RRRRRR.R..RRRRB
RRRRRRKR...RRR.
.ZRRR..RRRRRRRR
R..CR.RRR.W..RR
RR..R..ORRTLR..
R.R.RRP.RRR.RRR
RRR..RRR.RRR.RR
R.R...RFRMR.RRR
R.ARJ.RRRRRRRR.
RRRRD.R...R..RR
RRRR..RR.RRRRRR
.RRRRR.RRR.ENRR
RRRRRRRRRRU.RRR
