RRRORR.....RRR
RRRRR..VR.RRR.
RRRRK.RRP.ARRR
.M.RRRRRRRRRR.
RR..RRRRRRR.F.
RCRRRIRYRS.RR.
.J..R.R.RR.RRG
.RRRR.R...RR.R
R.RW..RD..QR.R
RRRX.R.RTRRZ.R
....RR.R...R.R
B...URER..LR.R
RHRRNRR.RRRRR.
..R.RR.RRRR.RR
