YRRRRRZR..R.W.RV
RRRRRRRRK.SRRRRR
RRR...R..R..RRR.
X.RRRRRR.R.ARRRR
.R..R.J.RRRRRR.R
FRRR.THRR.RRRR..
RRRRRRRRRRNRR.UR
RCRRRRRRRR..RRRR
...R.RRRRRR.RRR.
R.RRQORRRRRMIRRR
.RER.R.RRRRR.RRP
RRR.R.R.LR.RRRRR
RRR..RRR.RGRRRRR
.R...RRR.RR.R.R.
DRR.RRR.RRR.RRBR
RRRRR.RRRRR.RRRR
