J#T.P*....#.
FFXRY*...X*.
.*P.ZK.Q.#UZ
L##...**G.##
ED.BW..B.P..
SZF.YX#M#R#Y
...I.SN*#..#
.GK..D.V.#NV
QY#K.#.#C**#
HF.T..#WR#O.
*A.FY.SB##..
O#.H.D*..#.L
