R.RRVRRRR.RRR.O
R.RRRRRRRRUR.RR
.NRRR.RRRE.RR..
XR.RRRRJRRFR.RR
....CL.RRRAWRRR
RRR....RRRR.RRM
RRR.RR.RRR.R.T.
.RRRBRRRRRR...R
RR..DR...RRRR.R
RPRKRRR..SRRQRH
R.R...RR.RRRG.R
..RRR.RRRR.R..R
RRRRRR.RR.RRRRI
R..R.RY.RR.RZRR
RR.RR.RRR.RR...
