.RSBYL.R.RN
ERI.FPJR.R.
RRRZA.RRRR.
R.DRR.O.RRR
VRRR...W.RG
QRRCR.R.XRR
R..RRR.RR..
KURRRM.R..R
R.RT..RRRRR
R..R....RHR
.R.RRR...R.
