GPLG..#.OZESS
#*C##OHTT..U.
O#TC#B*#EAR.#
N..T..DZ.R.J#
..*I...##Y*#*
..WNXX.QP*P..
.*J....#*FOOB
#.IACC#*...#Z
..RZ*CSI#M.*D
Y...H.#UD#LR*
.#F*K#.WX.###
E...V.NN#.##.
