IRRRRR.RJP.R...
R..R.R.RRRR.TR.
RR.RGRRDRRRRRRR
C.RR.RRRO.RRRRR
R.R.N.R.RRR..R.
RRRRRR.RR.RRR.R
BR..RRARRR.RF.R
RRRRRR.R.RRRR..
LZM.R.RRRR.R.RR
R.RRR..RR.RRHV.
R.RR..XRRRRRR.R
R..RW.R.E.RRRR.
R.RRRYR.RRR.KR.
.RR.....RRRRQUR
R.R.R.RR.RRSRRR
