.V#E.H*.#.M#
N..NY.Y#JLB.
.F.*.UJT.*..
#.R#..B.NOL.
*#*.#C..RQ#X
DVKM.#PSF..*
#A.##LC.D..T
UYQDZ###E...
H*TGF.#*I.##
#..IX.FW#*.L
J..WH*ZG#.*.
