..T*X*VJ*W....
GIDC.BQJ.Y#Z#X
W.C#.B*E.###I#
*##.U##*##HA.H
*.#SX.L..*MQA#
RC*E..QG..X.#N
.SM.*JG#*SSB#.
.*Q..GWF.IP.#O
B.I.##UT#E#LA.
.YQ..M.#*.*C#.
.KU.B..CD#A..O
#*GH###OB..G.H
Q.#ZDKF..*X.#.
