RRMRRRERRA..RRY
RRRRRRRR...R.RR
.SOBRRRRRR.RRRT
RR.RLX.RRRRRVR.
R..RRRRRRR...RR
.R...RRR.RRIWRR
.R.RRR..R.RRR.R
JRRRRR.RRRRFR.R
R.R.RR.PRR.RRZR
RR....R.RRR.RRN
RHRR...R.Q.RRDR
RR.RRGR...RRRRR
RKRRRRRRR.RR..R
RRRRRRRRRRU.RRR
.RR.RRCRR..R..R
