.RRRR.R.GUR.RRR
RR.RDRRRR..RCR.
.RRR.R..R.RRRRR
.RRE.RR..VRRRRF
RRRR.Q.RR.RWRRR
RRHRKRM.RR.RRRR
.NR...RRRRR.RRR
RR..RRR..ILRRRR
.RR.RRRR.R.RRRZ
RR..XRRRBRRO.RR
RRR.R..RR.RRRSR
RRR.RR..RR.RR.R
RR..R.R.RTRRARR
JRRR.Y..R.PRRRR
